29 29 29 29 29 29 29 24 21 21 21 21 21 23 29 29 29 29 29 29
29 29 29 29 29 29 29 24 15 15 14 15 15 23 29 29 29 29 29 29
29 29 24 21 21 21 19 22 15 25 21 27 15 20 21 19 21 23 29 29
29 24 22 15 15 15 14 15 15 23 29 24 15 15 15 15 15 23 29 29
24 22 15 15 15 25 27 15 15 26 21 26 15 15 26 15 15 23 29 29
24 14 15 15 25 17 16 27 14 15 15 14 15 25 21 27 15 20 19 23
24 15 15 22 21 21 23 16 21 21 21 21 21 17 29 24 15 15 15 23
24 15 15 22 15 15 23 29 29 29 29 29 29 29 29 24 15 14 15 23
24 15 15 15 15 15 23 29 29 29 29 29 29 29 29 24 21 22 15 23
24 15 14 15 15 15 23 29 29 29 29 29 24 21 21 22 15 15 14 23
16 21 21 27 15 15 23 29 29 29 29 29 24 15 15 15 15 15 14 23
29 29 29 24 15 15 23 29 29 29 29 29 24 15 15 25 21 21 21 17
29 29 29 16 27 15 20 23 29 29 29 29 24 15 15 23 29 29 29 29
29 29 29 29 24 15 15 23 29 29 29 29 24 18 18 23 29 29 29 29
29 29 29 29 24 15 15 23 29 29 29 29 16 19 21 17 29 29 29 29
29 29 29 29 24 15 25 17 29 29 29 29 29 29 29 29 29 29 29 29
24 21 19 21 22 15 23 29 29 29 29 29 29 29 29 29 29 29 29 29
24 15 15 14 15 15 23 29 29 29 29 29 29 29 29 29 29 29 29 29
24 15 25 21 27 15 23 29 29 29 29 29 29 29 29 29 29 29 29 29
16 21 17 29 16 21 17 29 29 29 29 29 29 29 29 29 29 29 29 29