24 21 21 21 21 21 21 21 21 21 21 21 21 21 21 21 21 21 23 29
24 15 15 14 15 15 15 15 15 15 15 15 15 15 15 15 14 15 23 29
24 15 15 15 15 15 15 15 15 14 15 15 14 15 15 15 15 15 23 29
16 21 21 21 21 21 21 21 21 21 21 21 21 21 21 21 27 15 23 29
29 29 29 29 29 29 29 29 29 29 29 29 29 29 29 29 24 15 23 29
29 29 29 29 29 29 29 29 29 29 29 29 29 29 29 29 24 14 23 29
24 21 21 21 21 21 21 21 21 21 21 21 21 21 21 21 22 15 23 29
24 14 15 15 15 15 15 15 15 14 15 15 15 15 15 15 15 15 23 29
24 15 15 15 14 15 15 15 15 15 15 15 15 15 14 15 15 15 23 29
24 15 15 14 25 21 21 21 21 21 21 21 21 21 21 21 22 21 17 29
24 15 15 15 23 29 29 29 29 29 29 29 29 29 29 29 29 29 29 29
24 15 15 15 23 29 29 29 29 29 29 29 29 29 29 29 29 29 29 29
24 15 14 15 23 29 29 29 29 29 29 29 29 29 29 29 29 29 29 29
24 15 15 15 23 29 29 29 29 29 29 29 29 29 29 29 29 29 29 29
24 15 15 14 23 29 29 29 29 29 29 29 29 29 29 29 29 29 29 29
24 15 15 15 23 29 29 29 29 29 29 29 29 29 29 29 29 29 29 29
24 15 14 15 23 29 29 29 29 29 29 29 29 29 29 29 29 29 29 29
24 15 15 15 23 29 29 29 29 29 29 29 29 29 29 29 29 29 29 29
16 21 18 21 17 29 29 29 29 29 29 29 29 29 29 29 29 29 29 29
29 29 29 29 29 29 29 29 29 29 29 29 29 29 29 29 29 29 29 29