24 21 21 21 21 21 21 21 21 21 21 21 21 21 21 21 21 21 23 29
24 15 15 15 15 15 15 15 15 15 15 15 15 15 15 15 15 15 23 29
24 15 15 15 15 15 15 15 15 15 15 15 15 15 15 15 15 15 23 29
24 15 25 21 21 21 21 21 21 21 21 21 21 21 21 21 27 15 23 29
24 15 23 29 29 29 29 29 29 29 29 29 29 29 29 29 24 15 23 29
24 15 20 21 21 21 21 21 21 21 21 21 21 21 23 29 24 15 23 29
24 15 15 15 15 15 15 15 15 15 15 15 15 15 23 24 22 15 23 29
16 21 21 21 27 21 21 21 21 21 21 22 15 15 23 24 15 15 23 29
29 29 29 29 24 15 15 15 15 15 15 15 15 15 23 16 27 15 23 29
24 21 21 21 28 15 15 15 15 15 15 15 15 15 23 29 24 15 23 29
24 15 18 15 26 15 15 15 15 15 15 15 15 15 23 29 24 15 23 29
24 15 15 15 15 15 15 15 15 15 15 15 15 15 23 29 24 15 23 29
16 21 21 21 21 21 21 21 21 21 21 21 21 21 17 29 24 15 20 23
29 29 29 29 29 29 29 29 29 29 29 29 29 29 29 29 24 15 15 23
29 29 29 29 29 29 29 24 21 21 21 21 21 21 21 21 28 15 25 17
24 21 21 21 23 29 29 24 15 15 15 15 15 15 15 15 28 15 23 29
24 15 15 15 20 21 21 22 15 15 15 15 15 15 15 15 26 15 23 29
24 15 15 15 15 15 15 15 15 15 15 15 15 15 15 15 15 15 23 29
24 15 15 15 25 21 21 27 15 15 15 15 15 15 15 15 25 21 17 29
16 21 21 21 17 29 29 16 21 21 21 21 21 21 21 21 17 29 29 29